false_name	true_name	form
1More Piston Classic	1MORE Piston Classic	inear
1More Piston Fit	1MORE Piston Fit	inear
1More Quad Driver	1MORE Quad Driver	inear
1More Quad Driver In-Ear	1MORE Quad Driver	inear
1More Triple Driver	1MORE Triple Driver	inear
1More Triple Driver In-Ear	1MORE Triple Driver	inear
AfterShokz Aeropex	AfterShokz Aeropex	earbud
AfterShokz Aeropex Bone Conduction	AfterShokz Aeropex	earbud
AfterShokz Trekz Air	AfterShokz Trekz Air	earbud
AKG K240 MKII	AKG K240 MKII	onear
AKG K371	AKG K371	onear
AKG K391-NC	AKG K391-NC	inear
AKG K44	AKG K44	onear
AKG K490-NC	AKG K490-NC	onear
AKG K701	AKG K701	onear
AKG K702	AKG K702	onear
AKG K712 PRO	AKG K712 PRO	onear
AKG N200	AKG N200	inear
AKG N200 Wireless	AKG N200	inear
AKG N60NC Wireless	AKG N60 NC Wireless	onear
AKG N700NC	AKG N700NC	onear
AKG N700NC M2 Wireless	AKG N700NC M2	onear
AKG N700NC Wireless	AKG N700NC	onear
AKG Q701	AKG Q701	onear
Altec Lansing True Evo	Altec Lansing True Evo	inear
Amazon Echo Buds	Amazon Echo Buds	inear
Amazon Echo Buds Gen 2 Truly Wireless	Amazon Echo Buds Gen 2	inear
Amazon Echo Buds Truly Wireless	Amazon Echo Buds	inear
AmazonBasics Lightweight On Ear	AmazonBasics Lightweight On Ear	onear
Anker SoundBuds Curve	Anker SoundBuds Curve	inear
Anker SoundBuds Curve Upgraded 2019	Anker SoundBuds Curve Upgraded 2019	inear
Anker SoundBuds Curve Wireless	Anker SoundBuds Curve	inear
Anker SoundBuds Life	Anker SoundBuds Life	inear
Anker SoundBuds Sport	Anker SoundBuds Sport	inear
Anker Soundcore Liberty 2 Pro	Anker Soundcore Liberty 2 Pro	inear
Anker Soundcore Liberty 2 Pro Truly Wireless	Anker Soundcore Liberty 2 Pro	inear
Anker Soundcore Liberty 3 Pro Truly Wireless	Anker Soundcore Liberty 3 Pro	inear
Anker SoundCore Liberty Air	Anker SoundCore Liberty Air	inear
Anker SoundCore Liberty Air 2	Anker SoundCore Liberty Air 2	inear
Anker Soundcore Liberty Air 2 Pro	Anker Soundcore Liberty Air 2 Pro	inear
Anker Soundcore Liberty Air 2 Pro Truly Wireless	Anker Soundcore Liberty Air 2 Pro	inear
Anker SoundCore Liberty Air 2 Truly Wireless	Anker SoundCore Liberty Air 2	inear
Anker SoundCore Liberty Air Truly Wireless	Anker SoundCore Liberty Air	inear
Anker SoundCore Liberty Lite	Anker SoundCore Liberty Lite	inear
Anker SoundCore Liberty Lite Truly Wireless	Anker SoundCore Liberty Lite	inear
Anker SoundCore Life 2	Anker SoundCore Life 2	inear
Anker SoundCore Life 2 Wireless	Anker SoundCore Life 2	inear
Anker Soundcore Life A2 NC Truly Wireless	Anker Soundcore Life A2 NC	inear
Anker Soundcore Life Dot 2	Anker Soundcore Life Dot 2	inear
Anker Soundcore Life Dot 2 Truly Wireless	Anker Soundcore Life Dot 2	inear
Anker SoundCore Life P2	Anker SoundCore Life P2	inear
Anker SoundCore Life P2 Truly Wireless	Anker SoundCore Life P2	inear
Anker SoundCore Life P3 Truly Wireless	Anker SoundCore Life P3	inear
Anker Soundcore Life Q20	Anker Soundcore Life Q20	inear
Anker Soundcore Life Q20 Wireless	Anker Soundcore Life Q20	inear
Anker Soundcore Life Q30	Anker Soundcore Life Q30	onear
Anker Soundcore Life Q30 Wireless	Anker Soundcore Life Q30	onear
Anker Soundcore Life Q35 Wireless	Anker Soundcore Life Q35	onear
Anker SoundCore Space NC	Anker SoundCore Space NC	onear
Anker SoundCore Space NC Wireless	Anker SoundCore Space NC	onear
Anker Soundcore Spirit X	Anker Soundcore Spirit X	inear
Anker SoundCore Spirit X Wireless	Anker Soundcore Spirit X	inear
Anker Zolo Liberty+	Anker Zolo Liberty+	inear
Anker Zolo Liberty+ Truly Wireless	Anker Zolo Liberty+	inear
Apple AirPods	Apple AirPods	earbud
Apple AirPods (2nd generation) Truly Wireless	Apple AirPods 2nd generation	earbud
Apple AirPods (3rd generation) Truly Wireless	Apple AirPods 3rd generation	earbud
Apple AirPods 2 2019	Apple AirPods 2	earbud
Apple AirPods 2 Truly Wireless 2019	Apple AirPods 2	earbud
Apple AirPods Max	Apple AirPods Max	onear
Apple AirPods Max Wireless	Apple AirPods Max	onear
Apple AirPods Pro	Apple AirPods Pro	inear
Apple AirPods Pro Truly Wireless	Apple AirPods Pro	inear
Apple EarPods	Apple EarPods	earbud
Astro A10	ASTRO Gaming A10	onear
Astro A20	ASTRO Gaming A20	onear
Astro A20 Gen 2	ASTRO Gaming A20 Gen 2	onear
Astro A20 Gen 2 Wireless	ASTRO Gaming A20	onear
Astro A20 Wireless	ASTRO Gaming A20	onear
Astro A40	ASTRO Gaming A40	onear
Astro A40 2019	ASTRO Gaming A40 2019	onear
Astro A40 TR Headset + MixAmp Pro 2017		ignore
Astro A40 TR Headset + MixAmp Pro 2019		ignore
Astro A50	ASTRO Gaming A50	onear
Astro A50 Gen 3 Wireless 2017	ASTRO Gaming A50 Gen 3 2017	onear
Astro A50 Gen 4 2019	ASTRO Gaming A50 Gen 4 2019	onear
Astro A50 Gen 4 Wireless 2019	ASTRO Gaming A50 Gen 4 2019	onear
Audeze LCD 2 Classic/LC2C	Audeze LCD-2 Classic	onear
Audeze LCD-1	Audeze LCD-1	onear
Audeze LCD2-Classic	Audeze LCD-2 Classic	onear
Audeze Mobius	Audeze Mobius	onear
Audeze Penrose	Audeze Penrose	onear
Audeze Penrose Wireless	Audeze Penrose	onear
Audio-Technica ATH-AD700X	Audio-Technica ATH-AD700X	onear
Audio-Technica ATH-ANC23	Audio-Technica ATH-ANC23	inear
Audio-Technica ATH-ANC27x	Audio-Technica ATH-ANC27x	onear
Audio-Technica ATH-ANC29	Audio-Technica ATH-ANC29	onear
Audio-Technica ATH-ANC33iS	Audio-Technica ATH-ANC33iS	inear
Audio-Technica ATH-ANC70	Audio-Technica ATH-ANC70	onear
Audio-Technica ATH-ANC7b	Audio-Technica ATH-ANC7b	onear
Audio-Technica ATH-ANC7B SVIS	Audio-Technica ATH-ANC7B SVIS	onear
Audio-Technica ATH-ANC9	Audio-Technica ATH-ANC9	onear
Audio-Technica ATH-DSR9BT	Audio-Technica ATH-DSR9BT	onear
Audio-Technica ATH-DSR9BT Wireless	Audio-Technica ATH-DSR9BT	onear
Audio-Technica ATH-M20x	Audio-Technica ATH-M20x	onear
Audio-Technica ATH-M30x	Audio-Technica ATH-M30x	onear
Audio-Technica ATH-M40x	Audio-Technica ATH-M40x	onear
Audio-Technica ATH-M50x	Audio-Technica ATH-M50x	onear
Audio-Technica ATH-M50xBT	Audio-Technica ATH-M50xBT	onear
Audio-Technica ATH-M50xBT2 Wireless	Audio-Technica ATH-M50xBT2	onear
Audio-Technica ATH-M60x	Audio-Technica ATH-M60x	onear
Audio-Technica ATH-M70x	Audio-Technica ATH-M70x	onear
Audio-Technica ATH-MSR7NC	Audio-Technica ATH-MSR7NC	onear
AUKEY Latitude	AUKEY Latitude	inear
AUKEY Latitude Wireless	AUKEY Latitude	inear
B&O PLAY E8	Bang & Olufsen Beoplay E8	inear
B&O PLAY E8 2.0	Bang & Olufsen Beoplay E8 2.0	inear
B&O PLAY E8 3.0	Bang & Olufsen Beoplay E8 3.0	inear
B&O PLAY Earset 3i	Bang & Olufsen Beoplay Earset 3i	earbud
B&O PLAY Earset Wireless	Bang & Olufsen Beoplay Earset Wireless	earbud
B&O PLAY H6	Bang & Olufsen Beoplay H6	onear
B&O PLAY H9	Bang & Olufsen Beoplay H9	onear
B&O PLAY H9i	Bang & Olufsen Beoplay H9i	onear
Bang & Olufsen Beoplay H9i Wireless	Bang & Olufsen Beoplay H9i	onear
Bang & Olufsen Beoplay Portal	Bang & Olufsen Beoplay Portal	onear
Bang & Olufsen E8	Bang & Olufsen Beoplay E8	inear
Bang & Olufsen E8 2.0	Bang & Olufsen Beoplay E8 2.0	inear
Bang & Olufsen E8 3.0	Bang & Olufsen Beoplay E8 3.0	inear
Bang & Olufsen E8 3.0 True Wireless	Bang & Olufsen E8 3.0	inear
Bang & Olufsen Earset 3i	Bang & Olufsen Beoplay Earset 3i	earbud
Bang & Olufsen Earset Wireless	Bang & Olufsen Beoplay Earset Wireless	earbud
Bang & Olufsen H6	Bang & Olufsen Beoplay H6	onear
Bang & Olufsen H9	Bang & Olufsen Beoplay H9	onear
Bang & Olufsen H9i	Bang & Olufsen Beoplay H9i	onear
Beats BeatsX	Beats BeatsX	inear
Beats BeatsX Wireless	Beats X	inear
Beats EP	Beats EP On-Ear	onear
Beats EP On-Ear	Beats EP On-Ear	onear
Beats Executive	Beats Executive	onear
Beats Flex	Beats Flex	inear
Beats Flex Wireless	Beats Flex	inear
Beats Powerbeats 2 Wireless	Beats Powerbeats 2 Wireless	inear
Beats Powerbeats 4	Beats Powerbeats 4	inear
Beats Powerbeats 4 Wireless	Beats Power 4	inear
Beats Powerbeats Pro	Beats Powerbeats Pro	inear
Beats Powerbeats Pro Truly Wireless	Beats Power Pro	inear
Beats Powerbeats3 Wireless	Beats Powerbeats3 Wireless	inear
Beats Solo Pro	Beats Solo Pro	onear
Beats Solo Pro Wireless	Beats Solo Pro	onear
Beats Solo2 Wireless	Beats Solo2 Wireless	onear
Beats Solo3 2018 Wireless	Beats Solo3 2018	onear
Beats Solo3 2019	Beats Solo3 Wireless 2019	onear
Beats Solo3 2019 Wireless	Beats Solo3 Wireless 2019	onear
Beats Solo3 Wireless	Beats Solo3 Wireless	onear
Beats Studio Buds True Wireless	Beats Studio Buds	inear
Beats Studio Wireless	Beats Studio Wireless	onear
Beats Studio3 Wireless	Beats Studio3 Wireless	onear
Beats urBeats	Beats urBeats	inear
Beats urBeats3	Beats urBeats3	inear
Beats urBeats3 Earphones	Beats ur3	inear
Betron YSM1000	Betron YSM1000	inear
Beyerdynamic Amiron Wireless	Beyerdynamic Amiron Wireless	onear
Beyerdynamic DT 1770 PRO	Beyerdynamic DT 1770 (velour earpads)	onear
Beyerdynamic DT 1990 PRO	Beyerdynamic DT 1990 (balanced earpads)	onear
Beyerdynamic DT 770 PRO	Beyerdynamic DT 770 250 Ohm	onear
Beyerdynamic DT 770 Pro	Beyerdynamic DT 770 250 Ohm	onear
Beyerdynamic DT 880	Beyerdynamic DT 880 32 Ohm	onear
Beyerdynamic DT 990 PRO	Beyerdynamic DT 990 250 Ohm	onear
Beyerdynamic T1 2nd Generation	Beyerdynamic T1 2nd Generation	onear
Beyerdynamic T1 2nd Generation 2016	Beyerdynamic T1 2nd Generation	onear
BGVP DM6	BGVP DM6	inear
Bluedio T2S Turbine	Bluedio T2S Turbine	onear
Bluedio T3 Plus	Bluedio T3 Plus	onear
Bluedio T4	Bluedio T4	onear
Bluedio U Plus	Bluedio U Plus	onear
BlueParrott B450-XT		ignore
BlueParrott B450-XT Bluetooth Headset		ignore
Boltune BT-BH024	Boltune BT-BH024	inear
Boltune BT-BH024 Truly Wireless	Boltune BT-BH024	inear
Bose 700 Headphones Wireless	Bose Noise Cancelling Headphones 700	onear
Bose Hearphones	Bose Hearphones	inear
Bose Hearphones Wireless	Bose Hearphones	inear
Bose Noise Cancelling Headphones 700	Bose Noise Cancelling Headphones 700	onear
Bose QuietComfort 20	Bose QuietComfort 20	onear
Bose QuietComfort 20/QC20	Bose QuietComfort 20	inear
Bose QuietComfort 25	Bose QuietComfort 25	onear
Bose QuietComfort 25/QC25	Bose QuietComfort 25	onear
Bose QuietComfort 35	Bose QuietComfort 35	onear
Bose QuietComfort 35 II	Bose QuietComfort 35 II	onear
Bose QuietComfort 35 II/QC35 II Wireless 2018	Bose QuietComfort 35 II	onear
Bose QuietComfort 45/QC45 Wireless	Bose QuietComfort 45	onear
Bose QuietComfort Earbuds	Bose QuietComfort Earbuds	inear
Bose QuietComfort Earbuds Truly Wireless	Bose QuietComfort Earbuds	inear
Bose QuietControl 30	Bose QuietControl 30	onear
Bose QuietControl 30/QC30 Wireless	Bose QuietControl 30	onear
Bose SoundLink 2 Wireless	Bose SoundLink Around-Ear II	onear
Bose SoundLink Around-Ear II	Bose SoundLink Around-Ear II	onear
Bose SoundLink On-Ear	Bose SoundLink On-Ear	onear
Bose SoundSport Free	Bose SoundSport Free	inear
Bose SoundSport Free Truly Wireless	Bose SoundSport Free	inear
Bose SoundSport In-Ear	Bose SoundSport In-Ear	inear
Bose SoundSport Wireless	Bose SoundSport Wireless	inear
Bose SoundTrue Around-Ear II	Bose SoundTrue Around-Ear II	onear
Bose SoundTrue Ultra In-Ear	Bose SoundTrue Ultra In-Ear	inear
Bose SoundWear	Bose SoundWear	earbud
Bose Sport Earbuds	Bose Sport Earbuds	inear
Bose Sport Earbuds Truly Wireless	Bose Sport Earbuds	inear
Bose Sport Open Earbuds Truly Wireless	Bose Sport Open Earbuds	earbud
Bowers & Wilkins P5 S2	Bowers & Wilkins P5 Series 2	onear
Bowers & Wilkins P5 Wireless	Bowers & Wilkins P5 Wireless	onear
Bowers & Wilkins P7	Bowers & Wilkins P7	onear
Bowers & Wilkins PI7 True Wireless	Bowers & Wilkins PI7	inear
Bowers & Wilkins PX	Bowers & Wilkins PX	onear
Bowers & Wilkins PX Wireless	Bowers & Wilkins PX	onear
Bowers & Wilkins PX5	Bowers & Wilkins PX5	onear
Bowers & Wilkins PX5 Wireless	Bowers & Wilkins PX5	onear
Bowers & Wilkins PX7	Bowers & Wilkins PX7	onear
Bowers & Wilkins PX7 Wireless	Bowers & Wilkins PX7	onear
BRAINWAVZ HM5	Brainwavz HM5	onear
BÖHM B-66	BÖHM B-66	onear
Cambridge Audio Melomania 1	Cambridge Audio Melomania 1	inear
Cambridge Audio Melomania 1 Truly Wireless	Cambridge Audio Melomania 1	inear
Cambridge Audio Melomania 1+ True Wireless	Cambridge Audio Melomania 1+	inear
Cooler Master MH630	Cooler Master MH630	onear
Cooler Master MH751	Cooler Master MH751	onear
Corsair HS35	Corsair HS35	onear
Corsair HS50	Corsair HS50	onear
Corsair HS60	Corsair HS60	onear
Corsair HS60 HAPTIC	Corsair HS60 HAPTIC	onear
Corsair HS60 HAPTIC Stereo Gaming Headset	Corsair HS60 HAPTIC	onear
Corsair HS60 PRO SURROUND	Corsair HS60 PRO SURROUND	onear
Corsair HS70 Bluetooth	Corsair HS70 Bluetooth	onear
Corsair HS70 Wireless	Corsair HS70 Wireless	onear
Corsair HS75 XB WIRELESS	Corsair HS75 XB WIRELESS	onear
Corsair HS75 XB WIRELESS Gaming Headset	Corsair HS75 XB WIRELESS	onear
Corsair HS80 RGB WIRELESS	Corsair HS80 RGB WIRELESS	onear
Corsair Virtuoso RGB Wireless	Corsair Virtuoso RGB Wireless	onear
Corsair Virtuoso RGB Wireless SE	Corsair Virtuoso RGB Wireless SE	onear
Corsair VIRTUOSO RGB Wireless XT	Corsair VIRTUOSO RGB Wireless XT	onear
Corsair VOID ELITE	Corsair Void Elite	onear
Corsair Void PRO RGB Wireless	Corsair Void PRO RGB	onear
Corsair Void RGB	Corsair Void RGB	onear
Cougar Immersa	Cougar Immersa	onear
Cowin Apex Elite Truly Wireless	Cowin Apex Elite	inear
Cowin E7	Cowin E7	onear
Cowin E7 Pro	Cowin E7 Pro	onear
Cowin E7 Pro Wireless	Cowin E7 Pro	onear
Cowin E7 Wireless	Cowin E7	onear
Cowin E8	Cowin E8	onear
Cowin SE7	Cowin SE7	onear
Cowin SE7 Wireless	Cowin SE7	onear
Creative Aurvana Gold	Creative Aurvana Gold	onear
Creative Aurvana Platinum	Creative Aurvana Platinum	onear
Creative HN-900	Creative HN-900	onear
Creative Outlier Air	Creative Outlier Air	inear
Creative Outlier Air Truly Wireless	Creative Outlier Air	inear
Creative Outlier Air V2	Creative Outlier Air V2	inear
Creative Outlier Air V2 True Wireless	Creative Outlier Air V2	inear
Creative Sound Blaster EVO ZxR	Creative Sound Blaster EVO ZxR	onear
Creative Sound BlasterX H5	Creative Sound BlasterX H5	onear
Creative SXFI Air	Creative SXFI Air	onear
Creative SXFI Air Wireless	Creative SXFI Air	onear
Denon AHGC20	Denon AH-GC20	onear
Diskin Wireless Bluetooth	Diskin Wireless Bluetooth	onear
Dolby Dimension	Dolby Dimension	onear
Drop + Sennheiser HD 8XX	Sennheiser HD 8XX	onear
Drop + Sennheiser PC38X	Sennheiser PC38X	onear
Drop + THX Panda Wireless	Massdrop Panda	onear
EarFun Air Pro 2 True Wireless	EarFun Air Pro 2	inear
EarFun Air Pro True Wireless	EarFun Air Pro	inear
EarFun Free	EarFun Free	inear
EarFun Free Truly Wireless	EarFun Free	inear
ENACFIRE E60	ENACFIRE E60	inear
ENACFIRE E60 Truly Wireless	ENACFIRE E60	inear
EPOS GTW 270 Hybrid Truly Wireless	EPOS GTW 270 Hybrid	inear
EPOS Sennheiser GSP 600	EPOS Sennheiser GSP 600	onear
Etymotic ER4XR	Etymotic ER4XR	inear
Etymotic HF5	Etymotic hf5	inear
FIIL T1X	FIIL T1X	inear
FIIL T1X True Wireless	FIIL T1X	inear
Fitbit Flyer	Fitbit Flyer	inear
Focal Celestee	Focal Celestee	onear
Focal Clear Mg	Focal Clear Mg	onear
Focal Elear	Focal Elear	onear
Focal Elegia	Focal Elegia	onear
Focal Stellia	Focal Stellia	onear
Google Pixel Buds	Google Pixel Buds	earbud
Google Pixel Buds 2	Google Pixel Buds 2	inear
Google Pixel Buds 2017 Wireless	Google Pixel Buds 2017	inear
Google Pixel Buds 2020 Truly Wireless	Google Pixel Buds 2020	inear
Google Pixel Buds A-Series Truly Wireless	Google Pixel Buds A-Series	inear
Google Pixel USB-C	Google Pixel USB-C Earbuds	earbud
Google Pixel USB-C Earbuds	Google Pixel USB-C Earbuds	earbud
Grado GW100	Grado GW100	onear
Grado SR125e	Grado SR125e	onear
Grado SR225e	Grado SR225e	onear
Grado SR325e	Grado SR325e	onear
Grado SR60e	Grado SR60e	onear
Grado SR80e	Grado SR80e	onear
Grado The Hemp Headphone	Grado The Hemp Headphone	onear
Harman/Kardon NC	Harman Kardon NC	onear
HiFiMan Ananda	HIFIMAN Ananda	onear
HiFiMan ANANDA-BT	HIFIMAN Ananda BT	onear
HiFiMan ANANDA-BT Wireless	HIFIMAN Ananda BT	onear
HiFiMan Arya	HIFIMAN Arya	onear
HiFiMan Edition X	HIFIMAN Edition X	onear
HiFiMan HE-400i	HIFIMAN HE400i	onear
HiFiMan Sundara	HIFIMAN Sundara	onear
HiFiMan Sundara 2018	HIFIMAN Sundara 2018	onear
HiFiMan Sundara 2020	HIFIMAN Sundara 2020	onear
HyperX Cloud 2/Cloud II	HyperX Cloud II	onear
HyperX Cloud 2/Cloud II Wireless	HyperX Cloud II Wireless	onear
HyperX Cloud Alpha	HyperX Cloud Alpha	onear
HyperX Cloud Alpha S	HyperX Cloud Alpha S	onear
HyperX Cloud Core	HyperX Cloud Core	onear
HyperX Cloud Flight	HyperX Cloud Flight	onear
HyperX Cloud Flight S	HyperX Cloud Flight S	onear
HyperX Cloud II	HyperX Cloud II	onear
HyperX Cloud II Wireless	HyperX Cloud II Wireless	onear
HyperX Cloud Mix	HyperX Cloud Mix	onear
HyperX Cloud Revolver	HyperX Cloud Revolver	onear
HyperX Cloud Revolver + 7.1	HyperX Cloud Revolver + 7.1	onear
HyperX Cloud Stinger	HyperX Cloud Stinger	onear
HyperX Cloud Stinger S	HyperX Cloud Stinger S	onear
iClever Boostcare	iClever Boostcare	onear
iClever BTH02	iClever BTH02	onear
iClever BTH02 Wireless	iClever BTH02	onear
Jabra Elite 25e	Jabra Elite 25e	inear
Jabra Elite 3 True Wireless	Jabra Elite 3	inear
Jabra Elite 45e	Jabra Elite 45e	inear
Jabra Elite 65e	Jabra Elite 65e	inear
Jabra Elite 65t	Jabra Elite 65t	inear
Jabra Elite 65t Truly Wireless	Jabra Elite 65t	inear
Jabra Elite 75t	Jabra Elite 75t	inear
Jabra Elite 75t Truly Wireless	Jabra Elite 75t	inear
Jabra Elite 85h	Jabra Elite 85h	inear
Jabra Elite 85h Wireless	Jabra Elite 85h	inear
Jabra Elite 85t	Jabra Elite 85t	inear
Jabra Elite 85t Truly Wireless	Jabra Elite 85t	inear
Jabra Elite Active 45e	Jabra Elite Active 45e	inear
Jabra Elite Active 45e Wireless	Jabra Elite Active 45e	inear
Jabra Elite Active 65t	Jabra Elite Active 65t	inear
Jabra Elite Active 65t Truly Wireless	Jabra Elite Active 65t	inear
Jabra Elite Active 75t	Jabra Elite Active 75t	inear
Jabra Elite Active 75t Truly Wireless	Jabra Elite Active 75t	inear
Jabra Elite Sport	Jabra Elite Sport	inear
Jabra Evolve 65t	Jabra Evolve 65t	inear
Jabra Evolve 65t Truly Wireless	Jabra Evolve 65t	inear
Jabra Evolve2 65	Jabra Evolve2 65	onear
Jabra Evolve2 65 Wireless	Jabra Evolve2 65	onear
Jabra Evolve2 85	Jabra Evolve2 85	onear
Jabra Evolve2 85 Wireless	Jabra Evolve2 85	onear
Jabra Steel		ignore
Jabra Steel Bluetooth Headset		ignore
Jabra Talk 45		ignore
Jabra Talk 45 Bluetooth Headset		ignore
Jaybird Freedom	Jaybird Freedom	inear
Jaybird Freedom 2	Jaybird Freedom 2	inear
Jaybird Run	Jaybird Run	inear
Jaybird Run XT	Jaybird Run XT	inear
Jaybird Run XT Truly Wireless	Jaybird Run XT	inear
Jaybird Tarah	Jaybird Tarah	inear
Jaybird Tarah Pro	Jaybird Tarah Pro	inear
Jaybird Tarah Pro Wireless	Jaybird Tarah Pro	inear
Jaybird Tarah Wireless	Jaybird Tarah	inear
Jaybird Vista	Jaybird Vista	inear
Jaybird Vista 2 Truly Wireless	Jaybird Vista 2	inear
Jaybird X2	Jaybird X2	inear
Jaybird X3	Jaybird X3	inear
Jaybird X4	Jaybird X4	inear
Jaybird X4 Wireless	Jaybird X4	inear
JBL CLUB 700BT	JBL CLUB 700BT	onear
JBL CLUB 700BT Wireless	JBL CLUB 700BT	onear
JBL CLUB 950NC	JBL CLUB 950NC	onear
JBL CLUB 950NC Wireless	JBL CLUB 950NC	onear
JBL CLUB ONE	JBL CLUB ONE	onear
JBL CLUB ONE Wireless	JBL CLUB ONE	onear
JBL CLUB PRO Plus TWS	JBL CLUB PRO Plus TWS	inear
JBL CLUB PRO+ TWS True Wireless	JBL CLUB PRO Plus TWS	inear
JBL E25BT	JBL E25BT	inear
JBL E45BT	JBL E45BT	onear
JBL E45BT Wireless	JBL E45BT	onear
JBL E50BT	JBL E50BT	onear
JBL E55BT	JBL E55BT	onear
JBL E55BT Wireless	JBL E55BT	onear
JBL E65BTNC	JBL E65BTNC	onear
JBL E65BTNC Wireless	JBL E65BTNC	onear
JBL Endurance Dive	JBL Endurance Dive	inear
JBL Endurance Dive Wireless	JBL Endurance Dive	inear
JBL Endurance Peak	JBL Endurance Peak	inear
JBL Endurance Peak II	JBL Endurance Peak II	inear
JBL Endurance Peak II True Wireless	JBL Endurance Peak II	inear
JBL Endurance Peak Truly Wireless	JBL Endurance Peak	inear
JBL Endurance Sprint	JBL Endurance Sprint	inear
JBL Endurance Sprint Wireless	JBL Endurance Sprint	inear
JBL Everest 110	JBL Everest 110	inear
JBL Everest 110 Wireless	JBL Everest 110	inear
JBL Everest 310	JBL Everest 310	onear
JBL Everest 710	JBL Everest 710	onear
JBL Everest 710 Wireless	JBL Everest 710	onear
JBL Everest Elite 700	JBL Everest Elite 700	onear
JBL Free	JBL Free	inear
JBL Free Truly Wireless 2018	JBL Free 2018	inear
JBL Free X	JBL Free X	inear
JBL FreeX Truly Wireless	JBL Free X	inear
JBL JR300BT	JBL JR300BT	onear
JBL JR300BT Wireless	JBL JR300BT	onear
JBL Live 200BT	JBL Live 200BT	inear
JBL Live 200BT Wireless	JBL Live 200BT	inear
JBL LIVE 300TWS	JBL Live 300TWS	inear
JBL LIVE 300TWS Truly Wireless	JBL Live 300TWS	inear
JBL Live 400BT	JBL Live 400BT	onear
JBL Live 400BT Wireless	JBL Live 400BT	onear
JBL Live 460NC Wireless	JBL Live 460NC	onear
JBL Live 500BT	JBL Live 500BT	onear
JBL Live 500BT Wireless	JBL Live 500BT	onear
JBL Live 650 BTNC Wireless	JBL Live 650BTNC	onear
JBL Live 650BTNC	JBL Live 650BTNC	onear
JBL Live 660NC Wireless	JBL Live 660NC	onear
JBL Live Free NC+ TWS True Wireless	JBL Live Free NC+ TWS	inear
JBL Live Pro+ TWS True Wireless	JBL Live Pro+ TWS	inear
JBL Quantum 100	JBL Quantum 100	onear
JBL Quantum 400	JBL Quantum 400	onear
JBL Quantum 800	JBL Quantum 800	onear
JBL Quantum 800 Wireless	JBL Quantum 800	onear
JBL Quantum ONE	JBL Quantum ONE	onear
JBL Reflect Flow	JBL Reflect Flow	inear
JBL Reflect Flow True Wireless	JBL Reflect Flow	inear
JBL Reflect Mini 2	JBL Reflect Mini 2	inear
JBL Reflect Mini 2 Wireless	JBL Reflect Mini 2	inear
JBL T450BT	JBL T450BT	onear
JBL T450BT Wireless	JBL T450BT	onear
JBL Tour One Wireless	JBL Tour One	onear
JBL Tour Pro+ TWS True Wireless	JBL Tour Pro+ TWS	inear
JBL Tune 120	JBL TUNE 120TWS	inear
JBL Tune 120 Truly Wireless	JBL TUNE 120TWS	inear
JBL Tune 125TWS	JBL Tune 125TWS	inear
JBL Tune 125TWS Truly Wireless	JBL Tune 125TWS	inear
JBL TUNE 220TWS	JBL TUNE 220TWS	inear
JBL TUNE 220TWS Truly Wireless	JBL TUNE 220TWS	inear
JBL Tune 225TWS	JBL Tune 225TWS	inear
JBL Tune 225TWS True Wireless	JBL Tune 225TWS	inear
JBL Tune 510BT Wireless	JBL Tune 510BT	onear
JBL Tune 660NC Wireless	JBL Tune 660NC	onear
JBL TUNE 750BTNC	JBL TUNE 750BTNC	onear
JBL TUNE 750BTNC Wireless	JBL TUNE 750BTNC	onear
JBL Tune 760NC Wireless	JBL Tune 760NC	onear
JBL UA True Wireless Flash	Under Armour True Wireless Flash	inear
JBL Vibe 100TWS True Wireless	JBL Vibe 100TWS	inear
JLab Audio GO Air POP True Wireless	JLab Audio GO Air POP	inear
JLab Audio JBuds Air	JLab Audio JBuds Air	inear
JLab Audio JBuds Air ANC	JLab Audio JBuds Air ANC	inear
JLab Audio JBuds Air ANC Truly Wireless	JLab Audio JBuds Air ANC	inear
JLab Audio JBuds Air Executive	JLab Audio JBuds Air Executive	inear
JLab Audio JBuds Air Executive Truly Wireless	JLab Audio JBuds Air Executive	inear
JLab Audio JBuds Air Truly Wireless	JLab Audio JBuds Air	inear
Klipsch T5 II	Klipsch T5 II	inear
Klipsch T5 II True Wireless ANC	Klipsch T5 II True Wireless ANC	inear
Klipsch T5 II True Wireless Sport	Klipsch T5 II True Wireless Sport	inear
Klipsch T5 True Wireless	Klipsch T5 True Wireless	inear
Koss KSC75	Koss KSC75	onear
Koss Porta Pro	Koss Porta Pro	onear
Koss Porta Pro Wireless	Koss Porta Pro Wireless	onear
Koss QZ900	Koss QZ900	onear
Koss QZPro	Koss QZPro	onear
Koss UR-20	Koss UR 20	onear
KZ AS-10	KZ AS10	inear
KZ AS10	KZ AS10	inear
KZ ZS-10	KZ ZS10	inear
KZ ZSN	KZ ZSN	inear
KZ ZST	KZ ZST	inear
Logitech G Pro	Logitech G Pro	onear
Logitech G Pro X	Logitech G Pro X	onear
Logitech G Pro X Gaming Headset	Logitech G Pro X Lightspeed	onear
Logitech G PRO X WIRELESS LIGHTSPEED	Logitech G Pro X Lightspeed	onear
Logitech G PRO X WIRELESS LIGHTSPEED Gaming Headset	Logitech G Pro X Lightspeed	onear
Logitech G333	Logitech G333	inear
Logitech G335	Logitech G335	onear
Logitech G430	Logitech G430	onear
Logitech G432	Logitech G432	onear
Logitech G432 Gaming Headset	Logitech G432	onear
Logitech G433	Logitech G433	onear
Logitech G433 Gaming Headset	Logitech G433	onear
Logitech G435 LIGHTSPEED Wireless	Logitech G435 LIGHTSPEED	onear
Logitech G533	Logitech G533	onear
Logitech G533 Wireless Gaming Headset	Logitech G533	onear
Logitech G635	Logitech G635	onear
Logitech G635 Gaming Headset	Logitech G635	onear
Logitech G733 LIGHTSPEED	Logitech G733 LIGHTSPEED	onear
Logitech G733 LIGHTSPEED Wireless	Logitech G733 LIGHTSPEED	onear
Logitech G930	Logitech G930	onear
Logitech G933	Logitech G933	onear
Logitech G933 Wireless Gaming Headset	Logitech G933	onear
Logitech G935	Logitech G935	onear
Logitech G935 Wireless Gaming Headset	Logitech G935	onear
Logitech Zone Wired	Logitech Zone Wired	onear
LucidSound LS31	LucidSound LS31	onear
Marshall Major II	Marshall Major II	onear
Marshall MID ANC	Marshall MID ANC	onear
Marshall MID ANC Wireless	Marshall MID ANC	onear
MEE audio M6	MEE Audio M6	inear
MEE audio M6 PRO	MEE Audio M6 Pro	inear
MEE audio M9B	MEE Audio M9B	inear
MEE audio X6 Plus	MEE Audio X6 Plus	inear
MEE audio X7	MEE Audio X7	inear
Microsoft Surface Earbuds	Microsoft Surface Earbuds	earbud
Microsoft Surface Earbuds Truly Wireless	Microsoft Surface Earbuds	earbud
Microsoft Surface Headphones	Microsoft Surface Headphones	onear
Microsoft Surface Headphones 2	Microsoft Surface Headphones 2	onear
Microsoft Surface Headphones 2 Wireless	Microsoft Surface Headphones 2	onear
Microsoft Surface Wireless Headphones	Microsoft Surface Headphones	onear
Mixcder E9	Mixcder E9	onear
Mixcder E9 Wireless	Mixcder E9	onear
Monoprice Enhanced Active	Monoprice Enhanced Active	inear
Monoprice Noise Cancelling	Monoprice Noise Cancelling	onear
Monster Clarity 101 AirLinks	Monster Clarity 101 AirLinks	inear
Monster Clarity 101 AirLinks Truly Wireless	Monster Clarity 101 AirLinks	inear
Monster Inspiration	Monster Inspiration	onear
Motorola Squads 200	Motorola Squads 200	onear
Mpow BH015B Headset		ignore
Mpow Bluetooth Over-Ear	Mpow Bluetooth Over-Ear	onear
Mpow CH1	Mpow CH1	onear
Mpow CH6	Mpow CH6	onear
Mpow CH9	Mpow CH9	onear
Mpow CH9 Wireless	Mpow CH9	onear
Mpow EM12 Wireless Earphone		ignore
Mpow EM12 Wireless Earphone Bluetooth Headset		ignore
Mpow Flame Pro	Mpow Flame Pro	inear
Mpow Flame Pro Truly Wireless	Mpow Flame Pro	inear
Mpow H10	Mpow H10	onear
Mpow H10 Wireless	Mpow H10	onear
Mpow H5	Mpow H5	onear
Mpow H5 Wireless	Mpow H5	onear
Mpow Jaws	Mpow Jaws	inear
Mpow M30	Mpow M30	inear
Mpow M30 Truly Wireless	Mpow M30	inear
Mpow MDots True Wireless	Mpow MDots	inear
Mpow Pro Trucker Bluetooth Headset		ignore
Mpow X3	Mpow X3	inear
Mpow X3 Truly Wireless	Mpow X3	inear
Mpow X5	Mpow X5	inear
Mpow X5 Truly Wireless	Mpow X5	inear
Mpow X6 Truly Wireless	Mpow X6	inear
NAD VISO HP50	NAD VISO HP50	onear
Noontec Hammo Go	Noontec Hammo Go	onear
Nura NuraLoop	Nura NuraLoop	inear
Nura NuraLoop Wireless	Nura Loop	inear
Nura Nuraphone	Nura Nuraphone	onear
Nura Nuraphone Wireless	Nura phone	onear
OnePlus Buds	OnePlus Buds	inear
OnePlus Buds Pro Truly Wireless	OnePlus Buds Pro	inear
OnePlus Buds Truly Wireless	OnePlus Buds	inear
OnePlus Buds Z	OnePlus Buds Z	inear
OnePlus Buds Z Truly Wireless	OnePlus Buds Z	inear
Oppo PM-3	Oppo PM3	onear
Panasonic RP-HC101	Panasonic RP-HC101	onear
Panasonic RP-HC200	Panasonic RP-HC200	onear
Panasonic RP-HC56	Panasonic RP-HC56	inear
Panasonic RP-HC800	Panasonic RP-HC800	onear
Panasonic RP-HJE120	Panasonic RP-HJE120	inear
Parrot Zik 2.0	Parrot Zik 2.0	onear
Parrot Zik 3.0	Parrot Zik 3.0	onear
Philips Fidelio NC1	Philips Fidelio NC1	onear
Philips Fidelio X2HR	Philips Fidelio X2HR	onear
Philips Fidelio X3	Philips Fidelio X3	onear
Philips SHP9500	Philips SHP9500	onear
Philips SHP9600	Philips SHP9600	onear
Plane Quiet Platinum	Plane Quiet Platinum	onear
Plantronics BackBeat Fit	Plantronics BackBeat Fit	earbud
Plantronics BackBeat Go 600	Plantronics BackBeat Go 600	onear
Plantronics Backbeat Go 810	Plantronics Backbeat Go 810	onear
Plantronics BackBeat Go 810 Wireless	Plantronics Backbeat Go 810	onear
Plantronics Backbeat Pro	Plantronics Backbeat Pro	onear
Plantronics BackBeat Pro 2	Plantronics BackBeat Pro 2	onear
Plantronics BackBeat Pro 2 Wireless 2016	Plantronics BackBeat Pro 2	onear
Plantronics RIG 800LX	Plantronics RIG 800LX	onear
Plantronics RIG 800LX Wireless	Plantronics RIG 800LX	onear
Plantronics Voyager 3200		ignore
Plantronics Voyager 3200 Bluetooth Headset		ignore
Plantronics Voyager 5200		ignore
Plantronics Voyager 5200 Bluetooth Headset		ignore
Plantronics Voyager Legend		ignore
Plantronics Voyager Legend Bluetooth Headset		ignore
Polk Audio Buckle	Polk Audio Buckle	onear
Polk Audio UltraFocus 8000	Polk Audio UltraFocus 8000	onear
Puro JuniorJams	Puro JuniorJams	onear
Puro JuniorJams Wireless	Puro JuniorJams	onear
Raycon E100	Raycon E100	inear
Raycon E100 Truly Wireless	Raycon E100	inear
Raycon E25	Raycon E25	inear
Raycon E25 True Wireless	Raycon E25	inear
Raycon E50	Raycon E50	inear
Raycon E50 Truly Wireless	Raycon E50	inear
Raycon E55	Raycon E55	inear
Raycon E55 Truly Wireless	Raycon E55	inear
Raycon The Fitness Earbuds True Wireless	Raycon The Fitness Earbuds	inear
Razer Barracuda X Wireless	Razer Barracuda X	onear
Razer BlackShark V2	Razer BlackShark V2	onear
Razer BlackShark V2 Pro	Razer BlackShark V2 Pro	onear
Razer BlackShark V2 Pro Wireless	Razer BlackShark V2 Pro	onear
Razer BlackShark V2 X	Razer BlackShark V2 X	onear
Razer Hammerhead True Wireless	Razer Hammerhead True Wireless	earbud
Razer Hammerhead True Wireless 2019	Razer Hammerhead True Wireless 2019	inear
Razer Hammerhead True Wireless 2021	Razer Hammerhead True Wireless 2021	inear
Razer Hammerhead True Wireless Pro	Razer Hammerhead True Wireless Pro	inear
Razer Hammerhead USB-C	Razer Hammerhead USB-C	inear
Razer Hammerhead USB-C ANC	Razer Hammerhead USB-C ANC	inear
Razer Kaira Pro	Razer Kaira Pro	onear
Razer Kaira Pro Wireless	Razer Kaira Pro	onear
Razer Kaira Pro Wireless for Xbox	Razer Kaira Pro for Xbox	onear
Razer Kraken Pro V2	Razer Kraken Pro V2	onear
Razer Kraken Tournament Edition	Razer Kraken Tournament Edition	onear
Razer Kraken Ultimate	Razer Kraken Ultimate	onear
Razer Kraken USB	Razer Kraken USB	onear
Razer Kraken V3 X	Razer Kraken V3 X	onear
Razer Kraken X	Razer Kraken X	onear
Razer Man O' War	Razer Man O' War	onear
Razer Nari Ultimate	Razer Nari Ultimate	onear
Razer Nari Ultimate Wireless	Razer Nari Ultimate	onear
Razer Opus	Razer Opus	onear
Razer Opus Wireless	Razer Opus	onear
Razer Opus X Wireless	Razer Opus X	onear
RHA TrueConnect	RHA TrueConnect	inear
ROCCAT Elo 7.1 Air	ROCCAT Elo 7.1 Air	onear
ROCCAT Elo 7.1 Air Wireless	ROCCAT Elo 7.1 Air	onear
ROCCAT Syn Pro Air Wireless	ROCCAT Syn Pro Air	onear
Rovking V1	Rovking V1	inear
RUNMUS RGB K1 Gaming Headset	RUNMUS RGB K1 Gaming Headset	onear
Sabbat E12	Sabbat E12	inear
Sabbat E12 True Wireless	Sabbat E12	inear
Samson SR850	Samson SR850	onear
Samsung AKG Type-C	Samsung AKG EO-IG955 Type-C	inear
Samsung Galaxy Buds	Samsung Galaxy Buds	inear
Samsung Galaxy Buds Live	Samsung Galaxy Buds Live	earbud
Samsung Galaxy Buds Live Truly Wireless	Samsung Galaxy Buds Live	earbud
Samsung Galaxy Buds Plus	Samsung Galaxy Buds Plus	inear
Samsung Galaxy Buds Pro	Samsung Galaxy Buds Pro	inear
Samsung Galaxy Buds Pro Truly Wireless	Samsung Galaxy Buds Pro	inear
Samsung Galaxy Buds Truly Wireless	Samsung Galaxy Buds	inear
Samsung Galaxy Buds+ Truly Wireless	Samsung Galaxy Buds Plus	inear
Samsung Galaxy Buds2 Truly Wireless	Samsung Galaxy Buds2	inear
Samsung Gear IconX	Samsung Gear IconX	onear
Samsung Gear IconX Truly Wireless	Samsung Gear IconX	onear
Samsung Level On Wireless	Samsung Level On Wireless	onear
Samsung Level Over Wireless	Samsung Level Over Wireless	onear
Samsung Level U Pro	Samsung Level U Pro	onear
Samsung U Flex	Samsung U Flex	onear
Sennheiser AMBEO Smart Headset	Sennheiser AMBEO Smart Headset	inear
Sennheiser CX 400BT	Sennheiser CX 400BT	onear
Sennheiser CX 400BT True Wireless	Sennheiser CX 400BT	onear
Sennheiser CX Plus True Wireless	Sennheiser CX Plus True Wireless	inear
Sennheiser CX True Wireless	Sennheiser CX True Wireless	inear
Sennheiser CXC-700	Sennheiser CXC-700	inear
Sennheiser Game One	Sennheiser GAME ONE	onear
Sennheiser Game One Gaming Headset	Sennheiser GAME ONE	onear
Sennheiser HD 201	Sennheiser HD 201	onear
Sennheiser HD 202 II	Sennheiser HD 202 II	onear
Sennheiser HD 280 Pro	Sennheiser HD 280 Pro	onear
Sennheiser HD 280 Pro 2016	Sennheiser HD 280 Pro	onear
Sennheiser HD 4.40	Sennheiser HD 4.40	onear
Sennheiser HD 4.40 BT Wireless	Sennheiser HD 4.40BT	onear
Sennheiser HD 4.50	Sennheiser HD 4.50	onear
Sennheiser HD 4.50 BTNC	Sennheiser HD 4.50 BTNC	onear
Sennheiser HD 450BT	Sennheiser HD 450BT	onear
Sennheiser HD 450BT Wireless	Sennheiser HD 450BT	onear
Sennheiser HD 518	Sennheiser HD 518	onear
Sennheiser HD 560S	Sennheiser HD 560S	onear
Sennheiser HD 58X Jubilee	Sennheiser HD 58X	onear
Sennheiser HD 598	Sennheiser HD 598	onear
Sennheiser HD 598 Cs	Sennheiser HD 598 CS	onear
Sennheiser HD 599	Sennheiser HD 599	onear
Sennheiser HD 600	Sennheiser HD 600	onear
Sennheiser HD 650	Sennheiser HD 650	onear
Sennheiser HD 660 S	Sennheiser HD 660 S	onear
Sennheiser HD 6XX	Sennheiser HD 6XX	onear
Sennheiser HD 700	Sennheiser HD 700	onear
Sennheiser HD 800 S	Sennheiser HD 800 S	onear
Sennheiser HD 820	Sennheiser HD 820	onear
Sennheiser HD1 In-Ear Wireless	Sennheiser HD1 In-Ear Wireless	inear
Sennheiser IE 40 PRO	Sennheiser IE 40 PRO	inear
Sennheiser MM 450-X	Sennheiser MM 450-X	onear
Sennheiser MM 550-X	Sennheiser MM 550-X	onear
Sennheiser Momentum 2.0	Sennheiser Momentum 2.0	onear
Sennheiser Momentum 2.0 On-Ear	Sennheiser Momentum 2.0 On-Ear	onear
Sennheiser Momentum 2.0 Wireless	Sennheiser Momentum 2.0 Wireless	onear
Sennheiser Momentum 3 Wireless	Sennheiser Momentum 3 Wireless	onear
Sennheiser Momentum In-Ear	Sennheiser Momentum In-Ear	inear
Sennheiser Momentum True Wireless	Sennheiser Momentum True Wireless	inear
Sennheiser MOMENTUM True Wireless 2	Sennheiser Momentum True Wireless 2	inear
Sennheiser PXC 250 II	Sennheiser PXC 250 II	onear
Sennheiser PXC 450	Sennheiser PXC 450	onear
Sennheiser PXC 550 Wireless	Sennheiser PXC 550 Wireless	onear
Sennheiser PXC 550-II Wireless	Sennheiser PXC 550-II Wireless	onear
Sennheiser RS 165	Sennheiser RS 165	onear
Sennheiser RS 175	Sennheiser RS 175	onear
Sennheiser RS 185	Sennheiser RS 185	onear
Sennheiser RS 195	Sennheiser RS 195	onear
Sennheiser SC 160 USB-C Headset	Sennheiser SC 160 USB-C	onear
SENSO ActivBuds S-250	SENSO ActivBuds S-250	inear
Shure AONIC 50	Shure AONIC 50	onear
Shure AONIC 50 Wireless	Shure AONIC 50	onear
Shure SE215	Shure SE215	inear
Shure SE315	Shure SE315	inear
Shure SE425	Shure SE425	inear
Shure SRH240A	Shure SRH240A	onear
Shure SRH440	Shure SRH440	onear
Skullcandy Crusher	Skullcandy Crusher	onear
Skullcandy Crusher 360	Skullcandy Crusher 360	onear
Skullcandy Crusher 360 Wireless	Skullcandy Crusher 360	onear
Skullcandy Crusher Evo	Skullcandy Crusher Evo	onear
Skullcandy Crusher Evo Wireless	Skullcandy Crusher Evo	onear
Skullcandy Crusher Wireless	Skullcandy Crusher Wireless	onear
Skullcandy Crusher Wireless 2016	Skullcandy Crusher Wireless	onear
Skullcandy Dime True Wireless	Skullcandy Dime	inear
Skullcandy Grind	Skullcandy Grind	onear
Skullcandy Hesh 2	Skullcandy Hesh 2	onear
Skullcandy Hesh 3	Skullcandy Hesh 3	onear
Skullcandy Hesh 3 Wireless	Skullcandy Hesh 3	onear
Skullcandy Hesh ANC	Skullcandy Hesh ANC	onear
Skullcandy Hesh ANC Wireless	Skullcandy Hesh ANC	onear
Skullcandy Hesh Evo	Skullcandy Hesh Evo	onear
Skullcandy Hesh Evo Wireless	Skullcandy Hesh Evo	onear
Skullcandy Indy	Skullcandy Indy	inear
Skullcandy Indy ANC	Skullcandy Indy ANC	inear
Skullcandy Indy ANC True Wireless	Skullcandy Indy ANC	inear
Skullcandy Indy Evo	Skullcandy Indy Evo	inear
Skullcandy Indy Evo True Wireless	Skullcandy Indy Evo	inear
Skullcandy Indy Fuel	Skullcandy Indy Fuel	inear
Skullcandy Indy Fuel Truly Wireless	Skullcandy Indy Fuel	inear
Skullcandy Indy Truly Wireless	Skullcandy Indy	inear
Skullcandy Jib	Skullcandy Jib	inear
Skullcandy Jib True	Skullcandy Jib True	inear
Skullcandy Jib True Wireless	Skullcandy Jib True	inear
Skullcandy Jib Wireless	Skullcandy Jib	inear
Skullcandy Push	Skullcandy Push	inear
Skullcandy Push Truly Wireless	Skullcandy Push	inear
Skullcandy Push Ultra	Skullcandy Push Ultra	inear
Skullcandy Push Ultra Truly Wireless	Skullcandy Push Ultra	inear
Skullcandy Sesh	Skullcandy Sesh	inear
Skullcandy Sesh Evo	Skullcandy Sesh Evo	inear
Skullcandy Sesh Evo True Wireless	Skullcandy Sesh Evo	inear
Skullcandy Sesh Truly Wireless	Skullcandy Sesh	inear
Skullcandy Spoke True Wireless	Skullcandy Spoke	inear
Skullcandy Venue	Skullcandy Venue	onear
Skullcandy Venue Wireless	Skullcandy Venue	onear
SMS Audio STREET by 50 Active Noise Cancelling	SMS Audio Street by 50 Cent	onear
Sony MDR-1000X	Sony MDR-1000X	onear
Sony MDR-100AAP	Sony MDR-100AAP	onear
Sony MDR-1A	Sony MDR-1A	onear
Sony MDR-7506	Sony MDR-7506	onear
Sony MDR-7520	Sony MDR-7520	onear
Sony MDR-NC8	Sony MDR-NC8	onear
Sony MDR-XB50AP	Sony MDR-XB50AP	inear
Sony MDR-XB50AP Extra Bass	Sony MDR-XB50AP	inear
Sony MDR-XB950B1	Sony MDR-XB950B1	onear
Sony MDR-XB950N1	Sony MDR-XB950N1	onear
Sony MDR-ZX110NC	Sony MDR-ZX110NC	onear
Sony MDR-ZX550BN	Sony MDR-ZX550BN	onear
Sony MDR-ZX770BN	Sony MDR-ZX770BN	onear
Sony MH755	Sony MH755	inear
Sony MH755 (Fake)		ignore
Sony PULSE 3D	Sony PULSE 3D	onear
Sony PULSE 3D Wireless	Sony PULSE 3D	onear
Sony WF-1000X	Sony WF-1000X	inear
Sony WF-1000XM3	Sony WF-1000XM3	inear
Sony WF-1000XM3 Truly Wireless	Sony WF-1000XM3	inear
Sony WF-1000XM4 Truly Wireless	Sony WF-1000XM4	inear
Sony WF-C500 Truly Wireless	Sony WH-CH500	onear
Sony WF-SP700N	Sony WF-SP700N	inear
Sony WF-SP700N Truly Wireless	Sony WF-SP700N	inear
Sony WF-SP800N	Sony WF-SP800N	inear
Sony WF-SP800N Truly Wireless	Sony WF-SP800N	inear
Sony WF-XB700	Sony WF-XB700	inear
Sony WF-XB700 Truly Wireless	Sony WF-XB700	inear
Sony WH-1000XM2	Sony WH-1000XM2	onear
Sony WH-1000XM2 Wireless	Sony WH-1000XM2	onear
Sony WH-1000XM3	Sony WH-1000XM3	onear
Sony WH-1000XM3 Wireless	Sony WH-1000XM3	onear
Sony WH-1000XM4	Sony WH-1000XM4	onear
Sony WH-1000XM4 Wireless	Sony WH-1000XM4	onear
Sony WH-CH400	Sony WH-CH400	onear
Sony WH-CH400 Wireless	Sony WH-CH400	onear
Sony WH-CH500	Sony WH-CH500	onear
Sony WH-CH500 Wireless	Sony WH-CH500	onear
Sony WH-CH510	Sony WH-CH510	onear
Sony WH-CH510 Wireless	Sony WH-CH510	onear
Sony WH-CH700N	Sony WH-CH700N	onear
Sony WH-CH700N Wireless	Sony WH-CH700N	onear
Sony WH-CH710N	Sony WH-CH710N	onear
Sony WH-CH710N Wireless	Sony WH-CH710N	onear
Sony WH-H900N	Sony WH-H900N	onear
Sony WH-H900N/h.ear on 2 Wireless	Sony WH-H900N	onear
Sony WH-H910N	Sony WH-H910N	onear
Sony WH-H910N/h.ear on 3 Wireless	Sony WH-H910N	onear
Sony WH-XB700	Sony WH-XB700	onear
Sony WH-XB700 Wireless	Sony WH-XB700	onear
Sony WH-XB900N	Sony WH-XB900N	onear
Sony WH-XB900N Wireless	Sony WH-XB900N	onear
Sony WH-XB910N Wireless	Sony WH-XB910N	onear
Sony WI-1000X	Sony WI-1000X	inear
Sony WI-1000X Wireless	Sony WI-1000X	inear
Sony WI-1000XM2	Sony WI-1000XM2	inear
Sony WI-1000XM2 Wireless	Sony WI-1000XM2	inear
Sony WI-C200	Sony WI-C200	inear
Sony WI-C200 Wireless	Sony WI-C200	inear
Sony WI-C300	Sony WI-C300	inear
Sony WI-C310	Sony WI-C310	inear
Sony WI-C310 Wireless	Sony WI-C310	inear
Sony WI-C400	Sony WI-C400	inear
Sony WI-C400 Wireless	Sony WI-C400	inear
Sony WI-C600N	Sony WI-C600N	inear
Sony WI-C600N Wireless	Sony WI-C600N	inear
Sony WI-SP500	Sony WI-SP500	inear
Sony WI-SP600N	Sony WI-SP600N	inear
Sony WI-SP600N Wireless	Sony WI-SP600N	inear
Sony WI-XB400	Sony WI-XB400	inear
Sony WI-XB400 EXTRA BASS Wireless	Sony WI-XB400	inear
Sound Intone CX-05	Sound Intone CX-05	onear
SoundPeats Q8	SoundPeats Q8	inear
SoundPeats Q9A	SoundPeats Q9A	inear
SoundPeats QY8	SoundPeats QY8	inear
SoundPeats QY9	SoundPeats QY9	inear
SoundPeats TrueFree	SoundPeats TrueFree	inear
SoundPeats TrueFree 2	SoundPeats TrueFree 2	inear
SoundPeats TrueFree 2 Wireless	SoundPeats TrueFree 2	inear
SoundPeats TrueFree/True Wireless	SoundPeats TrueFree True	inear
Status Audio BT One	Status Audio BT One	onear
Status Audio BT One Wireless	Status Audio BT One	onear
Stax SR-L300	Stax SR-L300	onear
SteelSeries Arctis 1	SteelSeries Arctis 1	onear
SteelSeries Arctis 1 Wireless	SteelSeries Arctis 1 Wireless	onear
SteelSeries Arctis 3 2019 Edition	SteelSeries Arctis 3 2019 Edition	onear
SteelSeries Arctis 3 2019 Edition Wireless	SteelSeries Arctis 3 2019 Edition	onear
SteelSeries Arctis 5 2019 Edition	SteelSeries Arctis 5 2019 Edition	onear
SteelSeries Arctis 7	SteelSeries Arctis 7	onear
SteelSeries Arctis 7 2019 Edition	SteelSeries Arctis 7 2019 Edition	onear
SteelSeries Arctis 7 2019 Edition Wireless	SteelSeries Arctis 7 2019 Edition	onear
SteelSeries Arctis 7P	SteelSeries Arctis 7P	onear
SteelSeries Arctis 7P Wireless	SteelSeries Arctis 7P	onear
SteelSeries Arctis 7X Wireless	SteelSeries Arctis 7X	onear
SteelSeries Arctis 9	SteelSeries Arctis 9	onear
SteelSeries Arctis 9 Wireless	SteelSeries Arctis 9	onear
SteelSeries Arctis 9X	SteelSeries Arctis 9X	onear
SteelSeries Arctis 9X Wireless	SteelSeries Arctis 9X	onear
SteelSeries Arctis Prime	SteelSeries Arctis Prime	onear
SteelSeries Arctis Pro GameDAC	SteelSeries Arctis Pro GameDAC	onear
SteelSeries Arctis Pro Wireless	SteelSeries Arctis Pro Wireless	onear
SteelSeries Siberia 200	SteelSeries Siberia 200	onear
SteelSeries TUSQ	SteelSeries Tusq	inear
Superlux HD 668B	Superlux HD 668B	onear
Superlux HD 681	Superlux HD 681	onear
Superlux HD 681 EVO	Superlux HD 681 EVO	onear
Swimbuds Swimbuds	Swimbuds Swimbuds	inear
Symphonized NRG 3.0	Symphonized NRG 3.0	inear
TaoTronics SoundLiberty 79	TaoTronics SoundLiberty 79	inear
TaoTronics SoundLiberty 79 Truly Wireless	TaoTronics SoundLiberty 79	inear
TaoTronics SoundLiberty 92	TaoTronics SoundLiberty 92	inear
TaoTronics SoundLiberty 92 Truly Wireless	TaoTronics SoundLiberty 92	inear
TaoTronics SoundLiberty 94	TaoTronics SoundLiberty 94	inear
TaoTronics SoundLiberty 94 Truly Wireless	TaoTronics SoundLiberty 94	inear
TaoTronics SoundLiberty 95	TaoTronics SoundLiberty 95	earbud
TaoTronics SoundLiberty 95 Truly Wireless	TaoTronics SoundLiberty 95	earbud
TaoTronics SoundSurge 60 Wireless	TaoTronics SoundSurge 60	onear
TaoTronics TT-BH041		ignore
TaoTronics TT-BH041 Bluetooth Headset		ignore
TaoTronics TT-BH060	TaoTronics TT-BH060	onear
TaoTronics TT-BH060 Wireless	TaoTronics TT-BH060	onear
Tascam TH-02	Tascam TH-02	onear
TIN Audio T2	Tin HiFi T2	inear
TIN Audio T3	Tin HiFi T3	inear
TOZO NC2 Truly Wireless	TOZO NC2	inear
TOZO NC7 Truly Wireless	TOZO NC7	inear
TOZO NC9	TOZO NC9	inear
TOZO NC9 Truly Wireless	TOZO NC9	inear
TOZO T10	TOZO T10	inear
TOZO T10 Truly Wireless	TOZO T10	inear
TOZO T12	TOZO T12	inear
TOZO T12 Truly Wireless	TOZO T12	inear
TOZO T6	TOZO T6	inear
TOZO T6 Truly Wireless	TOZO T6	inear
Tranya T10	Tranya T10	inear
Tranya T10 Truly Wireless	Tranya T10	inear
TREBLAB X5	TREBLAB X5	inear
TREBLAB Z2	TREBLAB Z2	onear
TREBLAB Z2 Wireless	TREBLAB Z2	onear
Turtle Beach Battle Buds	Turtle Beach Battle Buds	inear
Turtle Beach Elite 800	Turtle Beach Elite 800	onear
Turtle Beach Elite Atlas	Turtle Beach Elite Atlas	onear
Turtle Beach Elite Atlas Aero	Turtle Beach Elite Atlas Aero	onear
Turtle Beach Elite Atlas Aero Wireless	Turtle Beach Elite Atlas Aero	onear
Turtle Beach Elite Pro 2 SuperAmp	Turtle Beach Elite Pro 2 SuperAmp	onear
Turtle Beach Recon 200	Turtle Beach Recon 200	onear
Turtle Beach Recon 200 Gen 2	Turtle Beach Recon 200 Gen 2	onear
Turtle Beach Recon 500	Turtle Beach Recon 500	onear
Turtle Beach Recon 50X	Turtle Beach Recon 50X	onear
Turtle Beach Recon 70	Turtle Beach Recon 70	inear
Turtle Beach Stealth 300	Turtle Beach Stealth 300	onear
Turtle Beach Stealth 600	Turtle Beach Stealth 600	onear
Turtle Beach Stealth 600 Gen 2	Turtle Beach Stealth 600 Gen 2	onear
Turtle Beach Stealth 600 Gen 2 Wireless	Turtle Beach Stealth 600 Gen 2	onear
Turtle Beach Stealth 600 Wireless	Turtle Beach Stealth 600	onear
Turtle Beach Stealth 700	Turtle Beach Stealth 700	onear
Turtle Beach Stealth 700 Gen 2	Turtle Beach Stealth 700 Gen 2	onear
Turtle Beach Stealth 700 Gen 2 Wireless	Turtle Beach Stealth 700 Gen 2	onear
Turtle Beach Stealth 700 Wireless	Turtle Beach Stealth 700	onear
Ultimate Ears FITS Truly Wireless	Ultimate Ears FITS	inear
V-MODA BassFit Wireless	V-MODA BassFit Wireless	inear
V-MODA Crossfade II Wireless	V-MODA Crossfade II Wireless	onear
V-MODA Crossfade M-100	V-MODA Crossfade M-100	onear
Venstone X1	Venstone X1	inear
Westone W40	Westone W40	inear
Wyze Buds Pro Truly Wireless	Wyze Buds Pro	inear
Wyze Noise-Cancelling Headphones Wireless	Wyze Noise-Cancelling Headphones	onear
Xbox Stereo Headset	Xbox Stereo Headset	onear
Xbox Wireless Headset	Xbox Wireless Headset	onear
XFYRO xS2	XFYRO xS2	inear
Ylife True Wireless Earbuds	Ylife True Wireless Earbuds	inear
